   ###
  ## # ####
 ##  ###  #
## $      #
#   @$ #  #
### ####  #
  #  #.   #
 ## ##.# ##
#       ##
#      ##
########