#######
#.@ # #
#$  $ #
#   $ #
# ..  #
#     #
#######